                                                                              
  #################################                                           
        #                  #            #########################             
        #                  #            #                       #             
        #                  #            #                       #             
        #               ######          #                       #             
        #               ################################        #             
        #               ######                   #              #             
        ######################                   #              #             
        #                                        #  #######################   
        #                                        #              #         #   
        ######################################   #                        #   
        #                                        #                        #   
        #                                        ##################       #   
        #                                        #                        #   
              ####################################                        #   
                   #         #   #           #                            #   
                   #     ####    #           #         #############$     #   
                   #     #       #           ###       #                  #   
                   ###############           ###       #                 ##   
                                             ##        #                      
                                             ##        #                      
                                              ##########                      
                                                                              